4
9

+-+-+-+-+
|       |
+-+-+ + +
|   | | |
+-+ +-+ +
| | |   |
+ + + +-+
| | |   |
+ + + + +
|S| | | |
+ + +-+ +
| |     |
+ +-+-+ +
|       |
+ +-+-+-+
| |T  | |
+ + + + +
|   |   |
+-+-+-+-+