6
10

+-+-+-+-+-+-+
|   |       |
+ + +-+-+-+ +
| |   |     |
+ +-+ + +-+ +
|T| | | |   |
+ + + + +-+ +
| |   |   | |
+ +-+-+-+ + +
|         | |
+-+-+-+-+-+ +
|           |
+ +-+-+-+-+-+
| |       | |
+ + +-+-+ + +
| | |   | |S|
+ + +-+ + + +
| |   |   | |
+ +-+ + +-+ +
|     |     |
+-+-+-+-+-+-+