9
9

+-+-+-+-+-+-+-+-+-+
|     |     |     |
+ +-+-+ + +-+ + +-+
| |     |     |   |
+ + +-+-+-+-+-+-+ +
| |     |       | |
+ +-+-+ + +-+-+ + +
|       | |   | | |
+-+-+-+-+-+ + + + +
|  S|       |   | |
+ + + +-+-+-+-+-+ +
| |   |           |
+ +-+-+ +-+-+-+-+ +
|   |       |     |
+-+ + +-+-+ + +-+-+
|   |    T| |     |
+ +-+-+-+-+ +-+-+ +
|           |     |
+-+-+-+-+-+-+-+-+-+