5
4

+-+-+-+-+-+
|S    |   |
+-+-+ + + +
|   | | | |
+ + + + +-+
| |   |   |
+ +-+-+-+ +
|        T|
+-+-+-+-+-+
