10
10
+-+-+-+-+-+-+-+-+-+-+
|       |         | |
+ +-+ + + +-+-+-+ + +
| |   | | |     | | |
+ + +-+ + +-+ + + + +
| | |   |   |T| |   |
+ + +-+ +-+ + +-+-+ +
| |S  |   | | |     |
+ +-+ +-+-+ + + +-+-+
| |   |     |   |   |
+ + + + +-+-+ +-+ + +
| | | |     | |   | |
+ + + +-+-+ + +-+ + +
| | | |   | |     | |
+ + + +-+ + +-+-+-+ +
| | |     | |     | |
+ + +-+-+ +-+ +-+-+ +
| |   |   |   |   | |
+ +-+ +-+-+ + + + + +
|   |       |   |   |
+-+-+-+-+-+-+-+-+-+-+