6
7

+-+-+-+-+-+-+
|     |     |
+ +-+ + +-+ +
| |T    | | |
+ + +-+-+ + +
| | | |     |
+ + + +-+-+-+
| | |       |
+ + +-+-+-+ +
| |   |   | |
+ +-+-+ + + +
| |     | | |
+ + +-+-+ + +
|       |  S|
+-+-+-+-+-+-+
