4
4

+-+-+-+-+
|  T    |
+-+-+-+ +
|       |
+-+-+-+ +
|S|     |
+ + +-+-+
|       |
+-+-+-+-+


        
